8	8	8	8	8	8	8	8	8	8	8	8	8	8	8	8	8	10	2	2	2	2	2	2	2	2	2	1	4	3	2	2	2	2	2	2	2	2	2	2	2	2	2	13	10	2	2	2	2	2	2	2	2	2	2	13	8	8	8	8	8	8	8	8	8	8	8	8	8	8	10	2	2	2	2	2	2	2	2	2	2	2	2	2	2	2	2	2	2	2	2	2	2	2	2	2	2	2	2	2
8	8	10	2	2	2	2	2	2	2	13	10	2	2	2	2	13	10	0	0	0	0	0	0	0	0	0	0	4	0	0	0	0	0	0	0	0	0	0	0	0	0	0	13	10	0	0	0	0	0	0	0	0	0	0	13	8	8	8	8	8	8	8	8	8	8	8	8	8	8	10	0	0	0	0	0	0	0	0	0	0	0	0	0	0	0	0	0	0	0	0	0	0	0	0	0	0	0	0	0
8	8	10	0	0	0	0	0	0	0	3	1	0	0	0	0	13	10	0	0	15	7	6	0	0	0	0	0	4	0	0	0	0	0	0	0	0	0	0	0	0	0	0	13	10	0	0	0	0	0	0	0	0	0	0	13	8	8	8	8	8	8	8	8	8	8	8	8	8	8	10	0	0	0	0	0	0	0	0	0	0	0	0	0	0	0	0	0	0	0	0	0	0	0	0	0	0	0	0	0
8	8	10	0	0	0	0	0	0	0	0	0	0	0	0	0	13	10	0	0	13	8	10	0	0	0	0	0	4	0	0	0	0	0	0	0	0	0	0	0	0	0	0	13	10	0	0	0	0	0	0	0	0	0	0	13	8	8	8	8	8	8	8	8	8	8	8	8	8	8	10	0	0	0	0	0	0	0	0	0	0	0	0	0	0	0	0	0	0	0	0	15	6	0	0	0	0	0	0	0
8	8	10	0	0	0	0	0	0	0	0	0	0	0	0	0	13	10	0	0	13	8	17	7	7	7	7	7	9	0	0	0	0	0	0	0	0	0	0	0	0	0	0	13	10	0	0	0	0	0	0	0	0	0	0	13	8	8	8	8	8	8	8	8	8	8	8	8	8	8	10	0	0	15	7	7	7	7	7	7	7	7	7	7	7	7	7	6	0	0	0	13	10	0	0	0	0	0	0	0
8	8	10	0	0	0	0	0	0	0	0	0	0	0	0	0	13	10	0	0	13	8	10	2	2	2	2	2	1	0	0	0	0	0	0	0	0	0	0	0	0	0	0	13	10	0	0	0	0	0	0	0	0	0	0	13	8	8	8	8	8	8	8	8	8	8	8	8	8	8	10	0	0	3	2	2	2	2	2	2	2	2	2	2	2	2	2	1	0	0	0	13	10	0	0	0	0	0	0	0
8	8	10	0	0	0	0	15	7	7	6	0	0	0	0	0	13	10	0	0	13	8	10	0	0	0	0	0	0	0	0	0	0	0	0	0	0	0	0	0	0	0	0	13	10	0	0	0	0	0	0	0	0	0	0	13	8	8	8	8	8	8	8	8	8	8	8	8	8	8	10	0	0	0	0	0	0	0	0	0	0	0	0	0	0	0	0	0	0	0	0	13	10	0	0	0	0	0	0	0
2	2	1	0	0	0	0	3	2	2	1	0	0	0	0	0	13	10	0	0	13	8	10	0	0	0	0	0	0	0	0	0	0	0	0	0	0	0	0	0	0	0	0	13	10	0	0	0	0	0	0	0	0	0	0	13	8	8	8	8	8	8	8	8	8	8	8	8	8	8	10	0	0	0	0	0	0	0	0	0	0	0	0	0	0	0	0	0	0	0	0	13	10	0	0	0	0	0	0	0
0	0	0	0	0	0	0	0	0	0	0	0	0	0	0	0	13	10	0	0	13	8	10	0	0	0	0	0	0	0	0	0	0	0	0	0	0	0	0	0	0	0	0	3	1	0	0	0	0	0	0	0	0	0	0	3	2	2	2	2	2	13	8	8	8	8	8	8	8	8	10	0	0	0	0	0	0	0	0	0	0	0	0	0	0	0	0	0	0	0	0	13	10	0	0	0	0	0	0	0
0	0	0	0	0	0	0	0	0	0	0	0	0	0	0	0	13	10	0	0	13	8	10	0	0	0	0	0	0	0	0	0	0	0	0	0	0	0	0	0	0	0	0	0	0	0	0	0	0	0	0	0	0	0	0	0	0	0	0	0	0	13	8	8	8	8	8	8	8	8	10	0	0	0	0	0	0	0	0	0	0	0	0	0	0	0	0	0	0	0	0	13	10	0	0	0	0	0	0	0
7	7	6	0	0	0	0	0	0	0	0	0	0	0	0	0	13	10	0	0	13	8	10	0	0	0	0	0	0	0	0	0	0	0	0	0	0	0	0	0	0	0	0	0	0	0	0	0	0	0	0	0	0	0	0	15	6	0	0	0	0	13	8	8	8	8	8	10	2	2	1	0	0	0	0	0	0	0	0	0	0	0	0	0	0	0	0	0	0	0	0	13	10	0	0	0	0	0	0	0
8	8	10	0	0	0	15	7	7	7	7	7	7	7	7	7	16	10	0	0	13	8	10	0	0	0	0	0	0	0	0	0	0	0	0	0	0	0	0	0	0	0	0	15	6	0	0	0	0	0	0	0	0	0	0	13	10	0	0	0	0	13	8	8	8	8	8	10	0	0	0	0	0	0	0	0	0	0	0	0	0	0	0	0	0	0	0	0	0	0	0	13	10	0	0	0	0	0	0	0
2	2	2	0	0	0	13	8	8	8	8	10	2	2	2	2	2	1	0	0	3	2	2	0	0	0	0	15	7	7	7	7	7	7	7	7	7	7	7	6	0	0	0	13	10	0	0	0	0	0	0	0	0	0	0	13	10	0	0	0	0	13	8	8	8	8	8	10	0	0	0	0	0	0	0	0	0	0	0	0	0	0	0	0	0	0	0	0	0	0	0	13	10	0	0	0	0	0	0	0
0	0	0	0	0	0	13	8	8	8	8	10	0	0	0	0	0	0	0	0	0	0	0	0	0	0	0	13	8	8	8	8	8	8	8	8	8	8	8	10	0	0	0	13	10	0	0	0	0	0	0	0	0	0	0	13	10	0	0	0	0	3	2	2	2	2	2	1	0	0	0	0	0	0	0	0	0	0	0	0	0	0	0	0	0	0	0	0	0	0	0	13	10	0	0	0	0	0	0	0
0	0	0	0	0	0	3	2	2	2	2	1	0	0	0	0	0	0	0	0	0	0	0	0	0	0	0	13	8	8	8	8	8	8	8	8	8	8	8	10	0	0	0	13	10	0	0	0	0	0	0	0	0	0	0	13	10	0	0	0	0	0	0	0	0	0	0	0	0	0	0	0	0	15	7	7	7	7	7	7	7	7	7	7	7	7	7	6	0	0	0	13	10	0	0	0	0	0	0	0
0	0	0	0	0	0	0	0	0	0	0	0	0	0	0	0	0	0	0	0	0	0	0	0	0	0	0	3	2	2	2	2	2	2	2	2	2	2	2	1	0	0	0	13	10	0	0	0	0	0	0	0	0	0	0	13	10	0	0	0	0	0	0	0	0	0	0	0	0	0	0	0	0	3	2	2	2	2	2	2	2	2	2	2	2	2	2	1	0	0	0	13	10	0	0	0	0	0	0	0
0	0	0	0	0	0	0	0	0	0	0	0	0	0	15	7	7	7	7	7	6	0	0	0	0	0	0	0	0	0	0	0	0	0	0	0	0	0	0	0	0	0	0	13	10	0	0	0	0	0	0	0	0	0	0	13	10	0	0	0	0	0	0	0	0	0	0	0	0	0	0	0	0	0	0	0	0	0	0	0	0	0	0	0	0	0	0	0	0	0	0	13	10	0	0	0	0	0	0	0
7	6	0	0	0	0	0	0	0	0	0	0	0	0	13	8	8	8	8	8	10	0	0	0	0	0	0	0	0	0	0	0	0	0	0	0	0	0	0	0	0	0	0	13	10	0	0	0	0	0	0	0	0	0	0	13	10	0	0	0	0	0	0	0	0	0	0	0	0	0	0	0	0	0	0	0	0	0	0	0	0	0	0	0	0	0	0	0	0	0	0	13	10	0	0	0	0	0	0	0
8	10	0	0	0	0	0	0	0	0	0	0	0	0	13	8	8	8	8	8	10	0	0	0	0	0	0	0	0	0	0	0	0	0	0	0	0	0	0	0	0	0	0	13	10	0	0	0	0	0	0	0	0	0	0	13	10	0	0	0	0	0	0	0	0	0	0	0	0	0	0	0	0	0	0	0	0	0	0	0	0	0	0	0	0	0	0	0	0	0	0	13	10	0	0	0	0	0	0	0
8	17	7	7	7	7	7	7	7	7	7	7	7	7	16	8	8	8	8	8	17	7	7	7	7	7	7	7	7	7	7	7	7	7	7	7	7	7	7	7	7	7	7	16	17	7	7	7	7	7	7	7	7	7	7	16	17	7	7	7	7	7	7	7	7	7	7	7	7	7	7	7	7	7	7	7	7	7	7	7	7	7	7	7	7	7	7	7	7	7	7	16	17	7	7	7	7	7	7	7
